Species	Category
African Elephant	Wild
Asian Elephant	Wild
Brachiosaurus	Extinct
Cat	Domesticated
Chimpanzee	Wild
Cow	Domesticated
Diplodocus	Extinct
Donkey	Domesticated
Giraffe	Wild
Goat	Domesticated
Gorilla	Wild
Grey Wolf	Wild
Guinea Pig	Wild
Hamster	Wild
Horse	Domesticated
Human	Wild
Jaguar	Wild
Kangaroo	Wild
Mole	Wild
Mouse	Wild
Pig	Domesticated
Potar Monkey	Wild
Rabbit	Wild
Rat	Wild
Rhesus Monkey	Wild
Sheep	Domesticated
Triceratops	Extinct